6
  ####
###  ####
#     $ #
# #  #$ #
# . .#@ #
#########