6
########
#      #
# .**$@#
#      #
#####  #
    ####