8
#######
#     #
# .$  #
##.$###
#  @  #
# .$# #
#     #
#######