6
###### #####
#    ###   #
# $$     #@#
# $ #...   #
#   ########
#####